#####################################
#       #           #       #       B
# ##### # ### ##### ### ##### ##### #
# #   #   # #   #   #   #   #   # # #
# # ##### # ##### ##### # ### # # # #
#       # #   # #     #   #   # #   #
##### ### ### # ##### ### # ##### ###
#   #   #   # # #     #   # #       #
# # ##### # # # # ##### ### ####### #
# # #   # # #   #   #   #       #   #
# # ### # ######### # ######### # # #
# #   #       #   # #   #       # # #
# ### ### ####### # ### ######### # #
#   #     #                       # #
############  #########  ########## #
#             #     #       #     # #
# ##### ### # ##### ### # ##### # # #
# #   # #   #   #     # #   #   # # #
# # ### # ### # ### # # ### ##### # #
# #     #   # #   # #   #       # # #
# # ##### # # # # ######### ##### # #
# #       #   # #       #   #     # #
# ########### # ##### # # ######### #
#       #       #   # # #   #       #
##### # ##### ##### # # ### #########
#   # #   #   #     #   #     #     #
# ### ##### ### ####### ### # ##### #
#   #   #   # #     #   #   #       #
##### ### # # ##### # ######### #####
#   #   # # # #   # #   #   #   #   #
# # ##### # ### # # # ### # ##### # #
# #   #   #   #   #   #   #   #   # #
# # ### ### ############# ### ### # #
# #   #A     #           #   #    # #
#####################################
